chunks;12
-1;-1
-1;-1;-1;-1;-1;-1;-1;-1;-1
-1;-1;-1;-1;-1;-1;-1;-1;-1
-1;-1;-1;-1;-1;-1;-1;-1;-1
-1;-1;-1;-1;-1;-1;-1;-1;-1
-1;-1;-1;6;6;6;6;6;6
-1;-1;-1;6;0;0;0;0;0
-1;-1;-1;6;0;6;0;6;6
-1;-1;-1;6;0;6;0;6;6
-1;-1;-1;6;0;6;0;0;0
0;-1
-1;-1;-1;-1;-1;-1;-1;-1;-1
-1;-1;-1;-1;-1;-1;-1;-1;-1
-1;-1;-1;-1;-1;-1;-1;-1;-1
-1;-1;-1;-1;-1;-1;-1;-1;-1
6;6;6;6;6;6;6;6;6
0;6;0;0;0;0;6;0;0
0;0;0;6;6;0;6;6;6
6;6;6;6;6;0;6;0;0
0;0;0;0;0;0;6;0;6
1;-1
-1;-1;-1;-1;-1;-1;-1;-1;-1
-1;-1;-1;-1;-1;-1;-1;-1;-1
-1;-1;-1;-1;-1;-1;-1;-1;-1
-1;-1;-1;-1;-1;-1;-1;-1;-1
6;6;6;6;6;6;6;6;6
0;0;6;0;0;0;6;6;0
6;0;6;0;6;0;0;0;0
0;0;6;0;6;0;6;6;6
6;6;6;0;6;0;0;0;0
2;-1
-1;-1;-1;-1;-1;-1;-1;-1;-1
-1;-1;-1;-1;-1;-1;-1;-1;-1
-1;-1;-1;-1;-1;-1;-1;-1;-1
-1;-1;-1;-1;-1;-1;-1;-1;-1
6;-1;-1;-1;-1;-1;-1;-1;-1
6;-1;-1;-1;-1;-1;-1;-1;-1
6;-1;-1;-1;-1;-1;-1;-1;-1
6;-1;-1;-1;-1;-1;-1;-1;-1
6;-1;-1;-1;-1;-1;-1;-1;-1
-1;0
-1;-1;-1;6;0;6;0;6;6
-1;-1;-1;6;0;0;0;0;0
-1;-1;-1;6;6;6;6;6;0
-1;-1;-1;6;0;0;0;0;0
-1;-1;-1;6;0;6;6;6;6
-1;-1;-1;6;0;0;0;0;0
-1;-1;-1;6;6;6;6;6;0
-1;-1;-1;6;0;0;0;6;0
-1;-1;-1;6;0;6;0;0;0
0;0
6;0;6;6;6;0;0;0;0
6;0;0;0;6;6;6;6;6
6;0;6;0;6;0;0;0;0
6;0;6;0;6;0;6;0;6
6;0;6;0;6;0;6;0;6
0;0;6;0;6;0;6;0;6
6;0;6;0;0;0;0;0;0
6;0;6;6;6;6;6;6;6
6;0;0;0;0;0;0;0;0
1;0
0;0;6;0;6;6;6;6;0
6;0;6;0;0;0;0;6;0
0;0;0;0;0;0;0;6;0
6;6;6;6;6;6;0;6;0
0;0;0;0;0;0;0;0;0
0;6;6;6;6;6;6;0;6
0;0;0;0;0;0;6;0;0
6;6;6;6;6;0;6;6;0
0;0;0;0;0;0;6;0;0
2;0
6;-1;-1;-1;-1;-1;-1;-1;-1
6;-1;-1;-1;-1;-1;-1;-1;-1
6;-1;-1;-1;-1;-1;-1;-1;-1
6;-1;-1;-1;-1;-1;-1;-1;-1
6;-1;-1;-1;-1;-1;-1;-1;-1
6;-1;-1;-1;-1;-1;-1;-1;-1
6;-1;-1;-1;-1;-1;-1;-1;-1
6;-1;-1;-1;-1;-1;-1;-1;-1
6;-1;-1;-1;-1;-1;-1;-1;-1
-1;1
-1;-1;-1;6;6;6;6;6;6
-1;-1;-1;-1;-1;-1;-1;-1;-1
-1;-1;-1;-1;-1;-1;-1;-1;-1
-1;-1;-1;-1;-1;-1;-1;-1;-1
-1;-1;-1;-1;-1;-1;-1;-1;-1
-1;-1;-1;-1;-1;-1;-1;-1;-1
-1;-1;-1;-1;-1;-1;-1;-1;-1
-1;-1;-1;-1;-1;-1;-1;-1;-1
-1;-1;-1;-1;-1;-1;-1;-1;-1
0;1
6;6;6;6;6;6;6;6;6
-1;-1;-1;-1;-1;-1;-1;-1;-1
-1;-1;-1;-1;-1;-1;-1;-1;-1
-1;-1;-1;-1;-1;-1;-1;-1;-1
-1;-1;-1;-1;-1;-1;-1;-1;-1
-1;-1;-1;-1;-1;-1;-1;-1;-1
-1;-1;-1;-1;-1;-1;-1;-1;-1
-1;-1;-1;-1;-1;-1;-1;-1;-1
-1;-1;-1;-1;-1;-1;-1;-1;-1
1;1
6;6;6;6;6;6;6;6;6
-1;-1;-1;-1;-1;-1;-1;-1;-1
-1;-1;-1;-1;-1;-1;-1;-1;-1
-1;-1;-1;-1;-1;-1;-1;-1;-1
-1;-1;-1;-1;-1;-1;-1;-1;-1
-1;-1;-1;-1;-1;-1;-1;-1;-1
-1;-1;-1;-1;-1;-1;-1;-1;-1
-1;-1;-1;-1;-1;-1;-1;-1;-1
-1;-1;-1;-1;-1;-1;-1;-1;-1
2;1
6;-1;-1;-1;-1;-1;-1;-1;-1
-1;-1;-1;-1;-1;-1;-1;-1;-1
-1;-1;-1;-1;-1;-1;-1;-1;-1
-1;-1;-1;-1;-1;-1;-1;-1;-1
-1;-1;-1;-1;-1;-1;-1;-1;-1
-1;-1;-1;-1;-1;-1;-1;-1;-1
-1;-1;-1;-1;-1;-1;-1;-1;-1
-1;-1;-1;-1;-1;-1;-1;-1;-1
-1;-1;-1;-1;-1;-1;-1;-1;-1
npc;0
warp;0
link;32
